1,23,23,23,23,23,23,23,23,23,23
1,,,,,,,,,,1
1,,,,,,,,,,1
1,,,,,,,,,,1
1,99,15,15,99,15,99,15,99,15,1
1,,1,,,,,,,,1
1,,99,,,,,,,,5
1,,1,,,,,,,,1
1,,1,99,23,,,35,,,5
1,99,1,,21,,,,,,1
1,,,,23,,,,,,5
1,,,,99,,,,,,1
1,,,,23,,,,,,5
1,,,,,,,,,,1
1,,,,0,,,,,,1
1,1,1,7,1,7,1,1,7,1,1