1,23,23,23,23,23,23,23,23,23,23
1,,,,,,,,,,1
1,,,,,,,,,,1
1,,,,,,,,,,1
1,15,15,15,99,15,99,15,99,15,1
1,0,1,0,0,0,0,0,0,0,1
1,0,99,0,0,0,0,0,,0,5
1,0,1,0,0,0,0,0,0,0,1
1,0,1,21,23,0,0,35,0,0,5
1,1,1,0,21,0,0,0,0,0,1
1,0,0,0,23,0,0,0,0,0,5
1,0,0,0,23,0,0,0,0,0,1
1,0,0,0,23,0,0,0,0,0,5
1,0,0,0,0,0,0,0,0,0,1
1,0,0,0,0,0,0,0,0,0,1
1,1,1,7,1,7,1,1,7,1,1