1,15,15,13,15,13,99,13,15,15,1
1,0,0,0,0,0,0,0,0,0,1
1,0,0,0,0,0,0,0,35,0,5
1,0,0,0,0,0,0,0,0,0,1
1,0,0,21,23,0,0,0,0,0,5
1,0,0,0,21,0,0,0,0,0,1
1,0,0,0,23,0,0,0,0,0,5
1,0,0,0,23,0,0,0,0,0,1
1,0,0,0,23,0,0,0,0,0,5
1,0,0,0,0,0,0,0,0,0,1
1,0,0,0,0,0,0,0,0,0,1
1,1,1,7,1,7,1,1,7,1,1