1111111111
1011000001
1010000001
1010010001
1000010001
1000011001
1000000001
1001001001
1000000001
1111111111