1111111111
1001000001
1001000001
1001000001
1000000001
1000000001
1100000111
1100000001
1000000001
1111111111