11111111111111111111111111111111111
10110000000000000000000010000000001
10100000000000000000000010000010001
10100100000001000000010010000100001
10000100000001000100010000001000001
10000110000001000000010000000000001
10000000000000000100000011110100001
10010010000011111000010000000000001
10000000000000000000000000000000001
11111111111111111111111111111111111